Id,Score,Red_splendor_cost,Yellow_splendor_cost,Green_splendor_cost,Black_splendor_cost,Blue_splendor_cost,White_splendor_cost,Splendor_type
1,4,0,0,4,1,1,0,2
2,3,0,0,2,1,4,0,3
3,4,2,0,2,1,1,0,0
4,3,2,0,2,1,0,0,4
5,4,0,0,0,1,1,4,5
6,3,2,0,2,1,0,0,4
7,4,0,0,2,1,1,2,3
8,3,2,0,2,1,0,0,2
9,4,0,0,2,1,1,2,0
10,3,2,0,2,1,0,0,3
